#majors
MNG = "countries/Mongolya.txt"
GHD = "countries/Great Horde.txt"
LTE = "countries/Latin Empire.txt"
TMR = "countries/Timurid Empire.txt"
TGH = "countries/Tughlaq.txt" # Bad Mistake, Lodi Dynasty in place in 1500

#japan
UES = "countries/Uyesugi.txt"
AIN = "countries/Ainu.txt"
HTY = "countries/Hatakeyama.txt"
KAG = "countries/Kagaikki.txt"
RYU = "countries/Ryuku.txt"

#china
CHU = "countries/Chu.txt"
DAL = "countries/Dali.txt"
UUU = "countries/U.txt"
TSG = "countries/Tsang.txt"
GUG = "countries/Guge.txt"
SHU = "countries/Shu.txt"
KRE = "countries/Koreaa.txt"
MIN = "countries/Min.txt"
NNG = "countries/Ning.txt"
WUU = "countries/Wu.txt"
YUE = "countries/Yue.txt"
XUE = "countries/Xu.txt"
QII = "countries/Qi.txt"
JIN = "countries/Jin.txt"
HAX = "countries/Haixi.txt"
LIA = "countries/Liang.txt"
MIA = "countries/Miao.txt"
CSH = "countries/Changsheng.txt"
WEI = "countries/Wei.txt"
YND = "countries/Yan.txt"
JZH = "countries/Jianzhou.txt"
YII = "countries/Yi.txt"
QIF = "countries/Qin.txt"

#europe
PAA = "countries/Achaea.txt"
ATN = "countries/Athens.txt"
THS = "countries/Thessalonica.txt"
DAP = "countries/Archipelago.txt" # Naxos
CCA = "countries/Circassia.txt"
CMK = "countries/Crimean Khanate.txt"
TDO = "countries/Theodoro.txt"

#middle east
GRG = "countries/Gyeorgia.txt"
MZD = "countries/Mazandaran.txt"
AJM = "countries/Ajam.txt"
KKY = "countries/Kara Koyunlu.txt"
SFV = "countries/Safavid.txt"
CKS = "countries/Chukhur Saad.txt"
AQQ = "countries/Aq Qoyunlu.txt"
FAR = "countries/Fars.txt"
ISF = "countries/Isfahan.txt"
BKK = "countries/Bukhara.txt"
KHZ = "countries/Khuzestan.txt"
CPI = "countries/Chupanid.txt"
FDL = "countries/Fadl.txt"
BKH = "countries/Balkh.txt"
SMK = "countries/Samarkand.txt"
HSS = "countries/Hissar.txt"
QHR = "countries/Candahar.txt"
KHV = "countries/Khiva.txt"
LUR = "countries/Luristan.txt"
YZD = "countries/Yazd.txt"
GIL = "countries/Gilan.txt"
MGH = "countries/Maragheh.txt"
##### Kurdish States
ARL = "countries/Ardalan.txt"
BIT = "countries/Bitlis.txt"
HAK = "countries/Hakkari.txt"
BHN = "countries/Bahdinan.txt"
HKF = "countries/Hasankeyf.txt"

#anatolia
NAA = "countries/Nicaea.txt"
AYD = "countries/Aydin.txt"
ERE = "countries/Eretna.txt"
KRM = "countries/Karaman.txt"
RUM = "countries/Rum.txt"
SKN = "countries/Sarukhanids.txt"
TBZ = "countries/Trebizond.txt"
RMZ = "countries/Ramazanids.txt"
MTE = "countries/Mentese.txt"
TKE = "countries/Teke.txt"
HDD = "countries/Hamidids.txt"
KAA = "countries/Karasids.txt"
GMY = "countries/Germiyanids.txt"
TCT = "countries/Tacettin.txt"
HCI = "countries/Haciemir.txt"
AIY = "countries/Alaiye.txt"

#arabia
HLL = "countries/Hail.txt"
MKA = "countries/Maskat.txt"
ORM = "countries/Hormuz.txt"
MHR = "countries/Mahra.txt"
YME = "countries/Yemen2.txt"
NJR = "countries/Najran.txt"
HJZ = "countries/Hejaz.txt"
ANZ = "countries/Anizah.txt"
HAA = "countries/Haasa.txt"
NJD = "countries/Najd.txt"

#india
ASS = "countries/Assam.txt" #lol
VIJ = "countries/Vijayanagara.txt" #had to look up how to spell this
BHM = "countries/Bahmanis.txt"
KHM = "countries/Kashmir.txt"
BNL = "countries/Bengal.txt"
SDH = "countries/Sindh.txt"
JNP = "countries/Jaunpur.txt"
ORS = "countries/Orissa.txt"
KCH = "countries/Kachar.txt"
NPA = "countries/Nepal2.txt" # Limbuwan
DNG = "countries/Dang.txt"
DOT = "countries/Doti.txt"
KMU = "countries/Kathmandu.txt"
QUT = "countries/Golconda.txt" # QUT = Qutb Shahi Dynasty
PGU = "countries/Hanthawaddy.txt" # PGU = Pegu
GJR = "countries/Gujarat.txt"
MWA = "countries/Malwa.txt"
RJC = "countries/Rajput.txt"
KHD = "countries/Khandesh.txt"
AHM = "countries/Ahmadnagar.txt"
BJP = "countries/Bijapur.txt"
BID = "countries/Bidar.txt"
BRR = "countries/Berar.txt"
GWA = "countries/Gondwana.txt"

#southeast asia
AVA = "countries/Ava.txt"
DVI = "countries/Dai Viet.txt"
CHP = "countries/Champa.txt"
KHE = "countries/Khmer.txt"
LNN = "countries/Lan Na.txt"
AYY = "countries/Ayutthaya.txt"
LXG = "countries/Lan Xang.txt"
MKU = "countries/Mrauk U.txt"
MKW = "countries/Mogaung.txt" # MKW = Mong Kawng
MPI = "countries/Mongpai.txt"
HSW = "countries/Hsenwi.txt"
HSI = "countries/Hsipaw.txt"
MGY = "countries/Mongyang.txt"
PRM = "countries/Prome.txt"
TOO = "countries/Toungoo.txt"
#####Indonesia
ATJ = "countries/Aceh.txt"
MCC = "countries/Malacca.txt"
KLE = "countries/Kelantan.txt"
KDH = "countries/Kedah.txt"
PHG = "countries/Pahang.txt"
BEI = "countries/Brunei2.txt"
PAS = "countries/Pasai.txt"
DEH = "countries/Deli.txt"
JMB = "countries/Jambi.txt"
PRY = "countries/Pagaruyung.txt"
PLE = "countries/Palembang.txt"
MJP = "countries/Majapahit.txt"
SDA = "countries/Sunda.txt"
UWU = "countries/Luwu.txt"
GOW = "countries/Gowa.txt"

#asian steppe
LDY = "countries/Liao.txt"
OIR = "countries/Oirat.txt"
CGT = "countries/Chagatai.txt"
YRK = "countries/Yarkent.txt" #yarkand
KIK = "countries/Kimek-Kipchak.txt"
OGH = "countries/Oghuz Yabgu.txt"
TSX = "countries/Transoxiana.txt"
FGH = "countries/Ferghana.txt"
KDL = "countries/Kara Del.txt" #replacing Kara Khitai
SYG = "countries/Sarig Yogir.txt"
KAM = "countries/Kham.txt"
NGI = "countries/Nogai.txt"
KZH = "countries/Kazakh.txt"
SIR = "countries/Sibir.txt"
ORD = "countries/Ordos.txt"
TUM = "countries/Tumed.txt"
YUS = "countries/Yunshebu.txt"
BYT = "countries/Buryat.txt"
GZM = "countries/Gazikumukh.txt"
KHO = "countries/Khorchin.txt"
YEN = "countries/Yenisei Kyrgyz.txt"
DZU = "countries/Dzungar.txt"
DOR = "countries/Dorbet.txt"
KOI = "countries/Khoid.txt"
KST = "countries/Khoshut.txt"
KZN = "countries/Qazan.txt"

#Formable
#GRT = "countries/Golden Horde.txt"
#ZHU = "countries/Zhongguo.txt"
PSE = "countries/Persian_Emp.txt"
GNH = "countries/Golden Horde.txt"
BHD = "countries/Blue Horde.txt"
NNN = "countries/Nepal3.txt"
MYS = "countries/Malay.txt"
NEU = "countries/Loyalist_Latin.txt"
NBZ = "countries/Roman Empire 2.txt"
HUS = "countries/Hindustan.txt"
CTF = "countries/Turfan.txt"

# Civil Conflicts
BGH = "countries/Baghdadi Revolt.txt"

#releaseable
AFT = "countries/Afghanystan.txt"
SGG = "countries/Sagaing.txt"
ARY = "countries/Armenya.txt"
AZJ = "countries/Azerbayjan.txt"
BCS = "countries/Baluchistan.txt"
KRS = "countries/Khorasan.txt"
EEE = "countries/E.txt"
ILK = "countries/Ilkhanate.txt"
ISY = "countries/Isfendiyarids.txt"
PGN = "countries/Pagan Kingdom.txt"
TKH = "countries/Astrakhan.txt"
SHN = "countries/Shun.txt"
UDG = "countries/Udege.txt"

#removed
#AAL = "countries/Aalst.txt"
#OGB = "countries/Old Bulgaria.txt"
#PCN = "countries/Pecheneg Khanate.txt"
DHL = "countries/Delhi_Democratic.txt"
DHS = "countries/Delhi_Socialist.txt"